# Cities PRO Keywords #

SENS_CITIES_PRO_NOISE	LITERAL1
SENS_CITIES_PRO_POLI1	LITERAL1
SENS_CITIES_PRO_GAS1	LITERAL1
SENS_CITIES_PRO_DUST	LITERAL1
SENS_CITIES_PRO_POLI2	LITERAL1
SENS_CITIES_PRO_GAS2	LITERAL1

SENS_CITIES_PRO_PWR_3V3	LITERAL1
SENS_CITIES_PRO_PWR_5V	LITERAL1
SENS_CITIES_PRO_PWR_BOTH	LITERAL1
SENS_CITIES_PRO_NO_PWR	LITERAL1

SCP_PWR_POLI_1	LITERAL1
SCP_I2C_MAIN_EN	LITERAL1
SCP_CS_NOISE	LITERAL1
SCP_PWR_NOISE	LITERAL1
SCP_PWR_DUST	LITERAL1
SCP_CS_DUST	LITERAL1
SCP_PWR_GAS_2	LITERAL1
SCP_I2C_GAS_2	LITERAL1
SCP_PWR_POLI_2	LITERAL1
SCP_PWR_GAS_1	LITERAL1
SCP_I2C_GAS_1	LITERAL1
SCP_POLI_1_ADC	LITERAL1
SCP_POLI_2_ADC	LITERAL1
SCP_NOISE_ADC	LITERAL1

FAST_MODE	LITERAL1
SLOW_MODE	LITERAL1

WaspSensorCitiesPRO	KEYWORD3
ON	KEYWORD2
OFF	KEYWORD2
setBoardMode	KEYWORD2
setSensorMode	KEYWORD2
setThreshold	KEYWORD2
setAudioGain	KEYWORD2
readValue	KEYWORD2
showLUT	KEYWORD2
readNoise	KEYWORD2
getSPLA	KEYWORD2
SPLA	KEYWORD2
noiseSensor	KEYWORD2

SensorCitiesPRO	KEYWORD1
noise	KEYWORD1
